0 8 4 5 8 5 3 3 3 0 7 9 4 1 9 7 7 2 7 8 
7 7 8 5 7 9 4 8 5 3 3 3 1 9 1 8 9 3 5 0 
4 4 8 5 3 4 9 5 8 7 2 2 5 5 5 5 3 2 4 8 
0 0 3 0 9 8 5 4 7 4 7 6 0 8 3 0 8 5 5 4 
0 7 1 2 5 9 3 5 3 7 2 7 5 2 7 9 8 8 9 1 
8 8 8 4 4 3 8 5 2 9 5 1 9 3 3 9 7 5 1 2 
2 9 7 5 8 5 8 5 3 4 3 0 0 4 5 7 7 2 1 5 
2 3 4 7 1 8 1 9 5 2 1 8 0 8 7 3 7 1 7 9 
4 0 9 2 4 7 0 7 7 8 1 1 5 9 1 4 9 3 2 9 
7 8 2 4 1 2 8 6 5 2 8 2 3 3 0 8 2 4 0 3 
